1111111111111111111111111111111111
1P0000000000000C00000C000000000001
1010010100100000101001000000010111
1010010010101010E01001000000010001
100000000C00C000000000000C000001C1
1111111111111111111111111111111111
