1111111111111111111111111111111111
10P000000000000C00000C000000000001
1010010100100000101001000000010111
1010010010101011E11001000000000011
1C0000000C00C000000000000C000001C1
1111111111111111111111111111111111
