11111111111111111111111111111
10P000000010000C0000000000001
10100101001001000010000010111
1010010010101E110010000000001
1C0000000C0000000000C000001C1
11111111111111111111111111111
