1111111
10P0C01
1000001
100E001
1000001
1111111