11111111
10000001
10E00001
10000P01
10C00001
11111111