1111111
1E00001
1000C01
1000C01
1P00001
1111111