1111111
1E00001
1000001
1000C01
10P0001
1111111