1111111111111111111111111111111
1P0C0010000000000010010C0000001
1111001111111111001001111001001
1000000001000001000000000001001
1111111001001111001111001111111
1001000001000000C00001000000001
1001111001111001111001001111001
1000000001000001001001001000001
1111111001111111001111001111001
1000000000001000001001001000001
1001001111111001111001001111111
10010010000010000010000C0001001
1001001111001111001111111001001
100100000C000001000000000001001
1111111111111001001111111001001
10000000000C00000000010000000E1
1111111111111111111111111111111