11111111111111111111111111111
10000000001000000000000000001
10100101001001000010000010111
10100100101010110010000000001
10000000000000000000000000101
10000000000000000000000000101
10000000000000000000000000101
10000000000000000000000000101
10000000000000000000000000101
10000000000000000000000000101
10000000000000000000000000101
10000000000000000000000000101
10000000000000000000000000101
10000000000000000000000000101
10000000000000000000000000101
10000000000000000000000000101
11111111111111111111111111111
