111111111111111
1C000000000C101
1C1C1C111010101
10101E101000001
100000C10000101
101010101010101
1C000000000C101
1C1011101010101
101000001000001
101110101101C01
100000C10000001
101010101010101
1P000000000C101
111111111111111