1111111
100C001
1000001
1000001
1PE0001
1111111